0 408 633 766 686 377 0 0 0 0 0 0 0 0 0 0 0 0 0 0 0 0 0 0 0 0 0 318 425 493
0 430 684 751 760 658 377 300 0 0 0 0 0 0 448 0 0 0 0 0 0 0 0 0 0 0 302 373 294 305
393 396 626 887 741 651 353 0 0 0 0 0 0 0 296 300 0 0 0 0 0 0 0 0 0 0 421 396 365 462
530 401 449 401 369 595 421 0 0 0 0 0 0 0 0 314 0 0 0 0 0 0 0 0 0 0 0 0 0 338
0 0 0 0 0 330 0 0 0 327 383 0 0 0 0 0 0 0 0 0 0 0 0 0 0 0 0 0 0 392
0 0 0 0 0 0 0 0 0 353 586 448 306 0 0 0 0 387 305 0 0 0 0 0 0 0 0 0 0 439
0 0 0 0 0 0 0 0 298 367 566 591 343 0 0 0 0 446 474 0 0 0 0 0 0 0 0 0 0 334
0 0 0 0 0 0 0 295 357 468 1000 558 354 0 0 0 0 366 364 0 0 0 0 0 0 0 0 0 327 397
0 0 0 0 0 0 0 299 0 301 556 674 416 0 0 0 0 287 319 0 0 0 0 0 0 0 0 0 352 384
0 0 0 0 0 0 0 0 0 0 487 599 589 357 0 0 0 310 335 0 0 0 0 0 0 0 0 0 349 420
0 0 0 0 0 0 0 0 0 0 500 786 614 305 0 0 0 0 314 0 0 0 0 0 0 0 0 0 445 513
0 0 0 0 0 0 0 0 0 0 350 552 533 352 0 0 0 0 0 301 0 0 0 315 354 0 0 302 418 614
0 0 0 0 0 0 0 0 0 0 0 419 383 0 0 0 0 0 419 303 356 0 0 0 498 362 296 0 348 609
0 0 281 315 292 0 0 0 0 0 0 0 0 0 0 0 0 0 292 0 0 0 0 395 326 343 0 0 0 289
0 532 473 367 419 325 0 0 0 0 0 0 0 0 0 0 0 0 0 0 0 0 0 415 348 0 0 0 0 0
396 391 300 417 403 0 0 0 0 0 0 417 0 0 0 0 0 0 0 0 0 0 0 361 404 0 0 0 0 0
729 417 287 0 0 0 0 0 0 0 370 395 284 0 0 0 0 0 0 0 0 0 336 396 436 321 310 0 0 0
280 383 327 0 0 0 0 0 291 0 569 743 347 0 0 0 0 0 0 0 0 342 346 321 285 0 501 474 352 296
0 0 0 0 0 0 0 0 376 583 720 534 0 0 0 0 0 0 0 0 0 344 563 375 0 300 466 320 0 0
0 0 0 0 0 0 0 493 583 610 661 360 0 0 0 0 0 0 0 0 0 452 435 499 0 0 290 0 0 0
0 0 0 0 0 0 0 291 424 358 654 628 0 0 0 0 0 0 0 0 0 531 495 341 0 0 0 0 0 0
0 0 0 0 0 0 0 0 288 555 871 571 402 362 343 0 0 0 0 0 0 383 454 0 0 0 0 0 0 0
0 0 0 0 0 0 0 0 280 465 340 620 432 317 361 0 0 0 0 393 355 365 0 0 0 0 0 0 0 0
0 0 0 0 0 0 308 0 0 318 315 0 0 0 365 299 0 0 0 0 0 0 0 0 0 0 0 0 0 0
0 0 0 0 0 484 437 349 0 0 0 0 0 0 301 477 439 0 0 0 0 0 0 0 0 0 0 0 0 0
0 0 285 321 449 282 362 0 0 0 0 0 0 0 0 398 599 421 0 0 0 0 0 0 0 0 0 0 317 426
417 598 489 292 389 611 288 0 0 0 0 0 0 0 0 407 552 481 404 0 0 0 0 0 0 0 0 0 507 313
342 441 695 549 510 408 294 0 0 0 0 0 0 0 288 568 478 395 281 0 0 0 0 0 0 0 0 285 319 0
0 419 987 613 388 315 0 0 0 0 0 0 0 325 556 423 478 0 0 0 0 0 0 0 0 0 0 300 319 0
336 607 797 396 385 316 0 0 0 0 0 0 0 0 438 385 476 0 0 0 0 0 0 0 0 0 0 0 359 0