0 0 0 0 0 0 0 0 0 0 0 0 0 0 299 456 507 376 0 0 0 0 0 0 0 0 0 0 0 0
0 0 0 0 0 0 0 0 0 0 0 0 0 0 0 278 338 0 0 0 0 0 0 0 0 0 0 342 398 361
0 0 0 0 0 0 0 289 346 314 0 0 0 0 0 0 0 0 0 0 0 0 0 0 0 0 0 334 423 393
0 0 0 0 0 0 311 401 421 349 0 0 0 0 0 0 0 0 0 0 0 0 0 0 0 0 0 0 359 366
0 0 318 383 387 394 441 470 430 329 0 0 0 0 0 0 278 0 0 0 0 0 0 0 0 0 0 0 343 380
0 405 590 687 651 582 500 411 323 0 0 0 0 0 0 313 309 0 0 0 0 0 0 0 0 0 0 0 369 434
390 672 857 861 733 576 402 0 0 0 0 0 0 0 377 430 344 0 0 0 0 0 0 0 0 0 0 278 413 476
614 906 946 766 560 374 0 0 0 0 0 0 0 421 572 566 373 0 0 0 0 0 0 0 0 0 0 370 451 457
747 947 835 549 337 0 0 0 0 0 0 0 319 533 707 646 389 0 0 0 0 0 0 0 0 0 350 452 448 369
692 784 607 344 0 0 0 0 0 0 0 0 333 556 731 662 407 0 0 0 0 0 0 0 0 0 379 430 365 0
566 570 393 0 0 0 0 0 0 0 0 0 332 552 724 654 414 0 0 0 0 0 0 0 0 0 348 350 0 0
380 325 0 0 0 0 0 0 0 0 0 0 344 511 614 538 358 0 0 0 0 0 0 0 0 0 280 0 0 0
0 0 0 0 0 0 0 0 0 0 0 310 357 396 396 332 0 0 0 0 0 0 0 0 0 0 0 0 0 0
0 0 0 0 0 0 0 0 298 378 414 388 324 0 0 0 0 0 0 0 0 0 0 0 0 0 0 0 0 0
0 0 0 0 0 0 286 479 593 577 471 347 0 0 0 0 0 0 0 296 446 494 396 0 0 0 0 0 0 0
0 0 0 0 0 0 479 713 764 601 382 0 0 0 0 0 0 0 0 355 605 716 557 314 0 0 0 0 0 0
0 0 0 0 0 296 526 722 690 472 0 0 0 0 0 0 0 0 0 374 623 740 575 326 0 0 0 0 0 0
0 0 0 0 0 303 520 659 556 334 0 0 0 0 0 0 0 0 0 375 586 671 507 291 0 0 0 0 0 0
0 0 0 0 0 358 557 620 450 0 0 0 0 0 0 0 0 0 0 349 497 497 333 0 0 0 0 0 0 0
0 0 0 0 327 450 597 594 401 0 0 0 0 0 0 0 0 0 0 310 378 303 0 0 0 0 0 0 0 0
0 0 0 323 406 490 589 577 416 0 0 0 0 0 0 0 0 0 0 278 274 0 0 0 0 0 0 0 0 0
0 0 0 310 367 414 497 533 458 293 0 0 0 0 0 0 0 0 0 0 0 0 0 0 0 0 0 0 0 0
0 0 0 0 0 273 350 431 449 349 0 0 0 0 0 0 0 0 0 0 0 0 0 0 0 0 311 478 496 341
0 0 0 0 0 0 0 312 378 344 0 0 0 0 0 0 0 0 0 0 0 0 0 0 0 0 490 756 784 559
0 0 0 0 0 0 0 0 293 308 0 0 0 0 0 0 0 0 0 0 0 0 0 0 0 344 617 934 1000 770
0 0 0 0 0 0 0 0 0 0 0 0 0 0 0 0 0 0 0 0 0 0 0 0 0 326 511 719 821 744
0 0 0 0 0 0 0 0 0 0 0 0 0 0 0 0 0 0 0 0 0 0 0 0 0 0 292 371 445 473
332 312 0 0 0 0 0 0 0 0 0 0 0 0 0 0 0 0 0 0 0 0 0 0 0 0 0 0 0 0
575 568 369 0 0 0 0 0 0 0 0 0 0 0 0 0 0 0 0 0 0 0 0 0 0 0 0 0 0 0
695 695 462 0 0 0 0 0 0 0 0 0 0 0 0 0 0 0 0 0 0 0 0 0 0 0 0 0 0 0