507 662 580 228 0 0 0 0 0 0 0 0 0 0 0 0 240 509 552 443 368 240 0 0 0 0 0 0 265 296
727 837 795 487 0 0 0 0 0 0 0 250 0 0 0 0 295 664 665 427 281 0 0 0 0 0 0 0 0 243
472 441 462 518 434 238 0 0 0 0 267 442 287 0 0 0 478 813 567 259 0 0 0 0 0 0 0 0 0 223
246 0 0 348 461 309 0 0 0 0 0 298 242 0 0 225 574 864 515 0 0 0 247 273 0 0 0 0 0 362
0 0 0 0 402 344 0 0 0 0 0 0 0 0 0 271 619 876 527 0 0 0 260 316 0 0 0 0 314 586
0 0 0 0 337 467 334 0 0 0 0 0 0 0 263 435 732 882 531 0 0 0 297 449 331 0 0 313 435 479
0 0 0 0 226 433 419 378 301 0 0 0 0 0 364 468 637 746 492 0 0 0 238 442 431 425 467 449 330 0
362 0 0 0 0 247 269 361 491 396 0 0 0 0 247 271 362 522 429 0 0 0 0 246 269 360 493 411 0 0
403 0 0 0 0 0 0 0 363 383 0 0 0 0 0 0 0 365 394 0 0 0 0 0 0 0 373 381 0 0
424 0 0 0 0 0 0 0 335 515 328 0 0 0 0 0 0 342 526 339 0 0 0 0 0 0 352 467 320 0
375 0 0 0 0 0 0 0 493 781 516 0 0 0 0 0 0 491 767 505 0 0 0 0 0 0 464 574 468 344
313 0 0 0 0 0 0 285 770 803 446 0 0 0 0 0 283 761 774 429 0 0 0 0 0 372 529 458 371 332
297 0 0 0 0 0 0 566 865 538 0 0 0 0 0 0 573 865 524 0 0 0 0 0 227 422 420 256 0 0
249 0 0 0 0 0 365 701 739 325 0 0 0 0 0 426 765 714 256 0 0 0 0 0 0 328 225 0 0 0
0 0 0 0 0 0 248 377 369 0 0 0 0 229 372 475 538 346 0 0 0 0 0 0 0 0 0 0 0 0
0 0 0 0 0 0 0 0 0 0 249 409 634 619 405 266 0 0 0 0 0 0 0 0 0 0 0 0 0 0
0 0 0 0 0 0 0 0 0 0 222 488 929 796 346 0 0 0 0 0 0 0 0 273 0 0 0 0 0 231
227 248 250 244 254 261 252 0 0 0 0 263 649 675 321 0 0 0 416 307 0 0 288 300 0 0 0 0 229 512
240 281 274 276 316 382 445 325 0 0 0 0 413 399 0 0 0 282 620 508 262 250 379 419 242 0 0 264 602 980
0 0 0 0 0 278 444 497 323 0 0 258 281 0 0 0 0 295 591 451 223 0 358 505 401 300 337 556 804 1000
0 0 0 0 0 0 285 490 509 358 292 292 0 0 0 0 0 326 439 269 0 0 0 344 352 340 368 421 452 469
0 0 0 0 0 0 227 423 421 252 0 0 0 0 0 0 254 423 401 0 0 0 0 0 0 0 0 0 0 0
261 438 386 0 0 0 0 291 229 0 0 0 0 0 280 304 415 565 465 247 0 0 0 0 0 0 0 0 0 0
499 836 732 303 0 0 0 0 0 0 0 0 0 0 0 240 412 637 597 411 269 0 0 0 0 0 0 0 0 0
414 663 606 307 0 0 0 0 0 0 0 0 0 0 0 0 305 530 541 458 426 503 557 411 0 0 0 0 0 0
0 274 276 0 0 0 0 0 0 0 0 0 0 0 0 0 322 424 336 276 306 492 621 433 0 0 0 0 0 0
0 0 0 0 0 255 269 0 0 0 0 0 0 0 0 317 513 411 0 0 0 238 322 0 0 0 0 0 0 0
0 0 0 0 319 598 655 410 0 0 0 0 0 0 0 336 478 337 0 0 0 0 0 0 0 0 0 0 0 0
0 0 0 0 370 766 845 554 0 0 0 0 0 0 0 0 245 266 0 0 0 0 0 237 0 0 0 0 0 0
0 0 0 0 267 433 462 349 0 0 0 0 0 0 0 0 0 293 293 0 0 0 0 295 305 342 425 360 0 0